NO ./pictures/shrek.xpmm
SO ./pictures/ane.xpmm
WE ./pictures/pupuce.xpmm
EA ./pictures/fiona.xpmm

F 220,100,0
C 225,100,234

111111111111111111                                                                                                                                              1111111
1N00001    0100001                                                                                                                                              1000001
1111101111111111011111111111111                                                                                                                                 1110111
1000000000000000000000000000001                                                                                                                                   101
1111111111111111111111111111101                                                                                                                                   101
1000100010001000111111111111001                                                                                                                                   101
1010001000100010000000000000001                                                                                                                                   101
101111111111111111111111111111111111111111111111111111111111111111111111111111111111111111111111111111111111111111111111111111111111111111111111111111111111111111101

100000000000000000000000000000000000000000000000000000000000000000000000000000000000000000000000000000000000000000000000000000000000000000000000000000000000000000001
111111111111111111111111111111111111111111111111111111111111111111111111111111111111111111111111111111111111111111111111111111111111111111111111111111111111111111101
                                                                                                                                                                  101
111111111111111111111111111111111111111111111111111111111111111111111111111111111111111111111111111111111111111111111111111111111111111111111111111111111111111111101
100000000000000000000000000000000000000000000000000000000000000000000000000000000000000000000000000000000000000000000000000000000000000000000000000000000000000000001
111111111111111111111111111111111111111111111111111111111111111111111111111111111111111111111111111111111111111111111111111111111111111111111111111111111111111111111
