NO ./pictures/shrek.xpmm
SO ./pictures/ane.xpmm
WE ./pictures/pupuce.xpmm
EA ./pictures/fiona.xpmm

F 220,100,0
C 225,100,234

11111111111111111111111111111111111
10E01111111111111111111111111000001
11110000000000000000000000000011011
11111111111111111111110000000011011
111000000000000000000000011111100111111111111
1000000000000110101010100001110011
1100011111111111111111110111110011
100011111110000000000000000000001
1111111111111111111111111111111111
