NO ./pictures/shrek.xpm
SO ./pictures/brique.xpm
WE ./pictures/pierre.xpm
EA ./pictures/fiona.xpm

F ,30,110
C 250,0,0

1111111111111111111111111111111
1110000000000000000000000000001
1110111111101000000000000000001
1100000000101000000000000000001
1100000000101111111110111111111
111111111110100000000000000000111
100000000000100000000000000000001
111111111111111111111111111111101
1000000100000000000000S0000000001
100000000000000000000000000000111
1111111111111011111111111111111
            101
        11111011111
        10000000001
        10000000001
        1000000000111111111111111111111111
        10000000001
        11111111111