   11111111111111111111111111111111111 11111111111111
   10010010000000000000000000000000001 10000000000001
   10011010111111111111111111111111101 10000000000001
   100000001                       101110000000000001
   101001111                       100000000000000001
111101101                          101110000000000001
10000000111111111111111111111111111101 10000000000001
11011101100111000000111000000011111001 10000000000001
10001000000000011110000011111000000001 11111111111111
1P001000111111111111111111111111111111
111111111