NO ./pictures/brique.xpm
SO ./pictures/brique.xpm
WE ./pictures/pierre.xpm
EA ./pictures/pierre.xpm

F 128,128,128
C 80,200,255

1111111111111111111111111111111
111S0000000000000000001000000011111111111111111111111111111111111
11111100001010000000001000000000000000000000000000000000000000001
11000000001010000000001000000011111111111111111111111111111111101
1100000000101111111110111001111                               101
111011111110100000000000000000111                             101
10000000000010000000000000000000111111111111111111111111111111101
11101111111111111111111111111110000000000000000000000000000000001
10000001000000000010000000100000111111111111111111111111111111111
100000000000101000000010000000111
1111111111111111111111111111111