NO ./pictures/shrek.xpm
SO ./pictures/ane.xpm
WE ./pictures/pupuce.xpm
EA ./pictures/shrek.xpm

F 220,100,0
C 225,100,234

1111111111111111111111111
1000000000110000000000001
1011000001110000000000001
1000000000000000000000001
111111111011000001110000111111111
100000000011000001110111111111111
11110111111111011100000010001
11110111111111011101010010001
11000000110101011100000010001
10000000000000001100000010001111111111111111111111111110
10000000000000000001010000001
11000001110101011111011110E0111
11110111 1110101 111111110001
11111111 1111111 11111101111100