111111111
100100101
100110101
101110101
101000001
101111101
100000001
110111011
100010001
1P0010001
111111111