   111111111
   100100101
   100110101
   100000001
   101001111
111101101
100000001
110111011
100010001
1P0010001
111111111