111111
1P0001
111001
100001
100001
111111
